gfx\\treeset.png
gfx\\bg2.png
15 10
1 2 1 2 1  1 2 1 2 1  1 2 1 2 0
2 1 2 1 2  2 1 2 1 2  2 1 2 1 0
1 0 0 0 0  0 0 0 0 0  0 0 0 0 0
2 1 2 1 2  2 1 2 1 2  2 1 2 1 2
1 2 1 2 1  1 2 1 2 1  1 2 1 2 1

2 1 2 1 2  2 1 2 1 2  2 1 2 1 2
1 2 1 2 1  1 2 1 2 1  1 2 1 2 1
0 0 0 0 0  0 0 0 0 0  0 0 0 0 1
0 2 1 2 1  2 1 2 1 2  2 1 2 1 2
0 1 2 1 2  1 2 1 2 1  1 2 1 2 1

1 1 2
2 1 1

1 2
13 7
Same color tiles can be swapped.~Move inside and press space.