gfx\\treeset.png
gfx\\bg3.png
25 25

1 0 1 0 1  1 1 1 1 1  0 0 0 0 0  1 0 1 0 1  1 0 1 0 1
0 0 0 0 0  1 1 1 1 0  0 1 1 1 0  0 0 1 0 0  0 0 0 0 0
1 0 1 0 1  1 1 1 1 0  0 1 1 1 0  1 1 1 1 1  1 0 1 0 1
0 0 0 0 0  1 1 1 1 0  0 1 1 1 0  0 0 1 0 0  0 0 0 0 0
1 0 1 0 1  1 1 1 1 1  0 0 0 0 0  1 0 1 0 1  1 0 1 0 1

1 0 1 0 1  1 1 1 1 1  1 1 1 1 1  1 1 1 1 1  1 1 1 1 1
0 0 1 0 0  1 0 0 0 0  0 0 0 0 0  0 0 0 0 0  1 1 1 1 1
1 1 1 1 1  1 0 1 1 1  1 1 1 1 1  1 1 1 1 1  1 1 1 1 1
0 0 1 0 0  1 0 1 0 0  0 0 0 0 0  0 0 0 0 1  1 1 1 1 1
1 0 1 0 1  1 0 1 0 1  1 1 1 1 1  1 1 1 0 1  1 0 0 0 1

0 0 0 0 0  1 0 1 0 0  0 1 1 1 1  1 1 1 0 1  0 0 0 0 0
0 1 1 1 0  1 0 1 1 1  1 1 1 1 1  1 1 1 0 1  0 1 1 1 0
0 1 1 1 0  1 0 1 1 1  0 0 0 0 0  1 1 1 0 1  0 1 1 1 0
0 1 1 1 0  1 0 1 1 1  1 1 1 1 1  1 1 1 0 1  0 1 1 1 0
0 0 0 0 0  1 0 1 1 1  1 1 1 1 0  0 0 1 0 1  0 0 0 0 0

1 0 0 0 1  1 0 1 1 1  1 1 1 1 1  1 0 1 0 1  1 0 1 0 1
1 1 1 1 1  1 0 0 0 0  0 0 0 0 0  0 0 1 0 1  0 0 1 0 0
1 1 1 1 1  1 1 1 1 1  1 1 1 1 1  1 1 1 0 1  1 1 1 1 1
1 1 1 1 1  0 0 0 0 0  0 0 0 0 0  0 0 0 0 1  0 0 1 0 0
1 1 1 1 1  1 1 1 1 1  1 1 1 1 1  1 1 1 1 1  1 0 1 0 1

1 0 1 0 1  1 0 1 0 1  0 0 0 0 0  1 1 1 1 1  1 0 1 0 1
0 0 0 0 0  0 0 1 0 0  0 1 1 1 0  0 1 1 1 1  0 0 0 0 0
1 0 1 0 1  1 1 1 1 1  0 1 1 1 0  0 1 1 1 1  1 0 1 0 1
0 0 0 0 0  0 0 1 0 0  0 1 1 1 0  0 1 1 1 1  0 0 0 0 0
1 0 1 0 1  1 0 1 0 1  0 0 0 0 0  1 1 1 1 1  1 0 1 0 1

9 3 6 2 9
2 4 8 4 3
7 5 9 7 5
3 4 6 4 2
9 2 8 3 9

10 10
14 14
