gfx\\mushroomset.png
gfx\\bg5.png
15 15
2 2 1 1 1  1 1 1 1 1  1 1 1 1 1
2 2 1 0 0  0 0 1 0 0  0 0 0 0 1
2 2 1 0 1  1 0 1 0 1  1 1 1 0 1
2 2 1 0 1  1 0 1 0 1  2 2 1 0 1
2 2 1 0 1  1 0 1 0 1  2 2 1 0 1

2 2 1 0 1  1 0 1 0 1  2 2 1 0 1
2 2 1 0 1  1 0 1 0 1  2 2 1 0 1
2 2 1 0 1  1 0 1 0 1  2 2 1 0 1
2 2 1 0 1  1 0 1 0 1  2 2 1 0 1
1 1 1 0 1  1 0 1 0 1  2 2 1 0 1

1 0 1 0 1  1 0 1 0 1  2 2 1 0 1
1 0 1 0 1  1 0 1 0 1  2 2 1 0 1
1 0 1 1 1  1 0 1 0 1  1 1 1 0 1
1 0 0 0 0  1 0 0 0 1  0 0 0 0 1
1 1 1 1 1  1 1 1 1 1  1 1 1 1 1

1 1 1
1 1 1
2 2 1

6 1
8 1