gfx\\snowset.png
gfx\\bg1.png
15 15

1 1 1 1 1  1 0 1 0 1  2 0 1 0 1
0 2 1 1 1  0 0 1 0 0  1 0 0 0 0
1 1 2 1 1  2 1 1 2 1  1 1 1 2 1
1 0 0 0 1  1 0 1 0 1  1 1 1 1 1
1 0 1 0 1  1 0 1 0 1  1 1 1 1 1

1 0 1 0 1  1 0 1 0 1  1 1 1 0 1
0 0 1 0 0  1 2 1 2 1  1 1 1 0 1
1 1 1 1 1  1 1 1 1 1  1 1 2 0 1
1 0 0 0 0  1 0 0 0 0  0 0 0 0 1
1 0 2 1 1  1 0 1 1 1  1 1 1 1 1

1 1 1 0 2  1 0 1 0 1  2 0 1 1 1
1 1 1 0 0  0 0 1 0 0  0 0 1 1 1
1 1 1 1 1  1 1 2 1 1  1 1 1 1 1
1 1 1 0 0  0 0 1 1 1  0 0 2 0 0
1 1 1 0 2  1 1 1 1 1  1 1 1 0 1

6 1 6
2 3 5
3 2 5

6 3
8 3

