gfx\\snowset.png
gfx\\bg3.png
20 20

0 0 1 1 1  1 1 1 1 1  1 1 0 0 0  1 1 1 1 1
1 0 0 0 1  1 1 1 0 0  0 0 0 1 1  1 1 1 1 1
1 1 1 0 1  1 1 1 0 1  1 1 1 1 1  1 1 1 1 1
1 0 1 0 1  1 1 1 0 1  1 0 0 0 0  1 1 1 1 1
1 0 1 0 1  1 1 1 0 1  1 0 1 1 0  1 1 1 1 1

0 0 1 1 0  1 1 1 0 0  1 0 1 0 1  1 1 1 1 1
1 1 1 1 0  1 1 1 1 1  0 0 1 0 1  1 1 1 1 1
1 1 1 1 1  1 1 1 1 1  1 1 1 0 1  1 1 1 1 1
1 1 1 1 1  1 1 1 1 1  0 0 0 0 1  1 1 1 1 1
1 1 0 0 0  1 1 1 1 1  0 1 1 1 1  1 1 1 1 1

1 1 1 1 1  1 1 0 0 1  0 0 1 1 1  1 1 1 1 1
1 1 1 1 1  1 1 1 0 0  1 0 0 0 1  0 0 0 0 1
1 1 1 1 1  1 1 1 1 1  1 1 1 0 1  1 1 1 0 1
1 1 1 1 1  1 1 0 0 0  1 0 1 0 1  0 0 1 0 1
1 1 1 1 1  1 1 0 1 1  1 0 1 0 1  1 0 1 0 1

1 1 1 1 1  1 1 0 1 0  1 1 0 1 1  1 0 1 0 1
1 1 1 1 1  1 1 0 0 0  1 1 0 1 1  1 0 0 0 1
1 1 1 1 1  1 1 1 1 1  1 1 0 1 1  1 1 1 1 1
1 1 1 1 1  1 1 1 1 1  1 1 0 0 0  0 1 1 1 1
1 1 1 1 1  1 1 1 1 1  1 1 1 1 1  0 1 1 1 1

9 9 9 1
9 9 9 1
1 5 5 5
1 5 5 5

1 3
11 13